################################################################
#                                                              #
#                                                              #
#                                                              #
#                                                          P   #
#                                                              #
#                                                              #
#                                                              #
#                                                              #
#                                                              #
#                                                              #
#                                                              #
#                                                              #
#                                                              #
#                                                              #
#                                                              #
#                                                              #
#                                                              #
#                                                              #
#                                                              #
#                                                              #
#                                                              #
#                                                              #
#                                                              #
#                                                              #
#                                                              #
#                                                              #
#                                                              #
#                                                              #
#                                                              #
#                                                              #
#                                                              #
#                                                              #
#                                                              #
#                                                              #
#   P                                                          #
#                                                              #
#                                                              #
#                                                              #
################################################################
